date_key,season_id,weather_id,casual_count,registered_count,total_count,temp_c,atemp_c,humidity_pct,windspeed_mph
20110101,1,2,331,654,985,8.175849,7.99925,80.58330000000001,10.749882
20110102,1,2,131,670,801,9.083466000000001,7.3467740000000035,69.6087,16.652113
20110103,1,1,120,1229,1349,1.229108,-3.499270000000001,43.7273,16.636703
20110104,1,1,108,1454,1562,1.4000000000000004,-1.9999479999999998,59.0435,10.739832
20110105,1,1,82,1518,1600,2.6669789999999995,-0.8681800000000006,43.695699999999995,12.522300000000001
20110106,1,1,88,1518,1606,1.6043559999999992,-0.6082059999999991,51.8261,6.0008684
20110107,1,2,148,1362,1510,1.2365340000000007,-2.2166259999999998,49.8696,11.304642
20110108,1,2,68,891,959,-0.24499999999999922,-5.291236,53.5833,17.875868
20110109,1,1,54,768,822,-1.4983489999999993,-8.33245,43.416700000000006,24.25065
20110110,1,1,41,1280,1321,-0.9108490000000007,-6.041392,48.2917,14.958889
20110111,1,2,43,1220,1263,-0.0527230000000003,-3.3633760000000006,68.6364,8.182844000000001
20110112,1,1,25,1137,1162,0.11816899999999997,-5.408782,59.954499999999996,20.410009
20110113,1,1,38,1368,1406,-0.24499999999999922,-6.041722,47.0417,20.166999999999998
20110114,1,1,54,1367,1421,-0.43910999999999945,-3.5647420000000007,53.7826,8.478716
20110115,1,2,222,1026,1248,2.9666510000000006,0.3753920000000015,49.875,10.583521
20110116,1,1,251,953,1204,2.888349,-0.5416779999999992,48.375,12.625010999999999
20110117,1,2,117,883,1000,0.264151,-4.333113999999998,53.75,12.999139
20110118,1,2,9,674,683,2.1833489999999998,-0.6660219999999999,86.16669999999999,9.833924999999999
20110119,1,2,78,1572,1650,5.732177999999999,3.695852000000002,74.1739,13.957239
20110120,1,2,83,1844,1927,4.298349,0.8333000000000013,53.833299999999994,13.125568
20110121,1,1,75,1468,1543,0.34249999999999936,-5.583022,45.7083,23.667214
20110122,1,1,93,888,981,-5.2208711999999995,-10.7814064,40.0,11.52199
20110123,1,1,150,836,986,-3.4634801,-9.4766194,43.6522,16.5222
20110124,1,1,86,1330,1416,-3.4226089,-8.21662,49.173899999999996,10.60811
20110125,1,2,186,1799,1985,2.5034660000000013,-0.5212839999999996,61.695699999999995,8.696332
20110126,1,3,34,472,506,2.2225,-2.5624000000000002,86.25,19.68795
20110127,1,1,15,416,431,1.165000000000001,-1.4998000000000005,68.75,7.627078999999999
20110128,1,2,38,1129,1167,1.563466,-1.2610780000000013,79.30430000000001,8.2611
20110129,1,1,123,975,1098,1.2365340000000007,-1.9996840000000002,65.17389999999999,9.739455
20110130,1,1,140,956,1096,2.176534,0.5212520000000005,72.2174,4.956834199999999
20110131,1,2,42,1459,1501,0.49915099999999946,-3.7074999999999996,60.375,12.541864
20110201,1,2,47,1313,1360,1.032178,-0.52102,82.9565,3.565271
20110202,1,2,72,1454,1526,4.220000000000001,0.7915220000000005,77.5417,17.708636
20110203,1,1,61,1489,1550,0.7869790000000005,-4.260052,43.7826,18.609384
20110204,1,2,88,1620,1708,1.9312880000000003,-0.913257999999999,58.521699999999996,8.565213
20110205,1,2,100,905,1005,2.9666510000000006,0.041827999999998866,92.91669999999999,10.792293
20110206,1,1,354,1269,1623,5.434151,3.2502860000000027,56.833299999999994,9.5006
20110207,1,1,120,1592,1712,4.768348999999999,4.041428,73.83330000000001,3.0423561
20110208,1,1,64,1466,1530,2.3791510000000002,-2.9157639999999994,53.7917,24.25065
20110209,1,2,53,1552,1605,-1.6651990000000003,-6.477322000000001,49.4783,12.652213
20110210,1,1,47,1491,1538,-1.2156440000000002,-6.129832,43.7391,14.869645
20110211,1,1,149,1597,1746,0.887277000000001,-1.9084059999999994,50.6364,7.272849999999999
20110212,1,1,288,1184,1472,2.4574999999999996,-0.6250359999999997,54.4167,13.625589
20110213,1,1,397,1192,1589,6.876534000000001,5.391458,45.7391,17.479160999999998
20110214,1,1,208,1705,1913,11.504999999999999,10.2911,37.583299999999994,27.999836
20110215,1,1,140,1675,1815,4.506089000000001,0.7820840000000011,31.434800000000003,19.522058
20110216,1,1,218,1897,2115,6.958267000000001,4.869199999999999,42.3478,16.869996999999998
20110217,1,1,259,2216,2475,12.484151,12.291428,50.5,15.416968
20110218,1,1,579,2348,2927,16.518349,17.790878,51.6667,17.749975000000003
20110219,1,1,532,1103,1635,10.760849,9.832663999999998,18.7917,34.000021
20110220,1,1,639,1173,1812,5.405199,2.3037799999999997,40.7826,14.956745
20110221,1,2,195,912,1107,6.2566510000000015,2.7489500000000007,60.5,20.625682
20110222,1,1,74,1376,1450,0.5644340000000003,-3.7218219999999995,57.7778,13.110761
20110223,1,1,139,1778,1917,2.4217329999999997,0.21732199999999935,42.3043,6.3055710000000005
20110224,1,2,100,1707,1807,5.895644000000001,3.0866059999999997,69.7391,16.783231999999998
20110225,1,2,120,1341,1461,9.124355999999999,7.130426,71.2174,23.218113
20110226,1,1,424,1545,1969,5.277499999999998,2.6246720000000003,53.7917,12.500257
20110227,1,1,694,1708,2402,8.143466,7.173193999999999,68.0,8.391615999999999
20110228,1,2,81,1365,1446,11.141831,10.407787999999996,87.63640000000001,19.408962
20110301,1,1,137,1714,1851,4.533348999999999,1.416013999999997,53.5,14.500475
20110302,1,1,231,1903,2134,7.745000000000001,5.1246860000000005,44.9583,20.624811
20110303,1,1,123,1562,1685,1.321651000000001,-2.7912219999999994,31.833299999999998,15.125518000000001
20110304,1,2,214,1730,1944,4.298349,0.8748140000000006,61.0417,13.624182
20110305,1,2,640,1437,2077,10.055848999999998,8.999413999999998,78.91669999999999,16.875357
20110306,1,2,114,491,605,9.696534,8.172632,94.8261,23.000229
20110307,1,1,244,1628,1872,4.3017330000000005,-0.26157399999999953,55.1304,22.870584
20110308,1,1,316,1817,2133,5.747499999999999,3.958400000000001,42.0833,8.083549999999999
20110309,1,2,191,1700,1891,5.904151000000001,2.916127999999997,77.5417,14.750050000000002
20110310,1,3,46,577,623,10.287277,9.454088000000002,0.0,17.545759
20110311,1,2,247,1730,1977,6.876534000000001,4.129999999999999,64.95649999999999,15.60899
20110312,1,1,724,1408,2132,7.470848999999999,5.499499999999998,59.458299999999994,14.791924999999999
20110313,1,1,982,1435,2417,10.064356,9.086006000000001,52.73910000000001,18.130468
20110314,1,1,359,1687,2046,7.285198999999999,5.912000000000003,49.695699999999995,9.174042
20110315,1,2,289,1767,2056,6.917376999999998,4.999748,65.5652,12.348703
20110316,1,2,321,1871,2192,9.165199000000001,8.217379999999999,77.65220000000001,13.608839
20110317,1,1,424,2320,2744,11.504999999999999,11.081978,60.291700000000006,14.041792999999998
20110318,1,1,884,2355,3239,17.380000000000003,18.782593999999996,52.5217,15.478139
20110319,1,1,1424,1693,3117,14.2075,14.790650000000003,37.9167,24.667189
20110320,1,1,1047,1424,2471,7.627500000000001,5.499499999999998,47.375,13.917307
20110321,2,2,401,1676,2077,12.230445,11.04251,73.73910000000001,19.348461
20110322,2,1,460,2243,2703,12.758348999999999,13.082372,62.4583,15.125250000000001
20110323,2,2,203,1918,2121,8.306979000000002,6.303974,83.9565,15.695487
20110324,2,2,166,1699,1865,5.395,1.8749779999999987,80.58330000000001,16.333729
20110325,2,1,300,1910,2210,4.415849,0.9165919999999979,49.5,15.458575000000002
20110326,2,1,981,1515,2496,4.494150999999999,0.9996860000000005,39.4167,14.041257
20110327,2,2,472,1221,1693,3.893021000000001,0.5223739999999992,49.3913,12.348099999999999
20110328,2,1,222,1806,2028,4.424356000000001,0.9998840000000015,30.2174,14.217668
20110329,2,1,317,2108,2425,6.217499999999999,3.3319280000000013,31.4167,15.208732
20110330,2,2,168,1368,1536,6.1,3.6250999999999998,64.6667,11.583495999999998
20110331,2,3,179,1506,1685,4.611651,0.9999499999999983,91.8333,14.582282000000001
20110401,2,2,307,1920,2227,6.1,2.7079640000000005,68.625,17.333436
20110402,2,2,898,1354,2252,6.805,4.832042000000001,65.375,13.208782
20110403,2,1,1651,1598,3249,9.781651,8.998622000000001,48.0,12.208271000000002
20110404,2,1,734,2381,3115,18.946651,19.833314,42.625,25.833257
20110405,2,2,167,1628,1795,11.465848999999999,10.2911,64.2083,26.000488999999998
20110406,2,1,413,2395,2808,10.369150999999999,9.582128,47.0833,17.625221
20110407,2,1,571,2570,3141,12.5625,12.623936,60.291700000000006,10.874904
20110408,2,2,172,1299,1471,7.784151,5.4156140000000015,83.625,15.208464
20110409,2,2,879,1576,2455,8.0975,6.540914000000001,87.75,8.916561
20110410,2,2,1188,1707,2895,12.053349,12.164641999999997,85.75,9.833389
20110411,2,2,855,2493,3348,19.995644,21.304322,71.6956,21.739758
20110412,2,2,257,1777,2034,15.617499999999996,16.541564,73.9167,18.416892999999998
20110413,2,2,209,1953,2162,11.3875,11.540678,81.91669999999999,16.791338999999997
20110414,2,1,529,2738,3267,13.9725,14.540972,54.041700000000006,7.4169
20110415,2,1,642,2484,3126,12.993348999999998,13.166258,67.125,15.167124999999999
20110416,2,3,121,674,795,12.249151000000001,12.082472,88.83330000000001,22.834136
20110417,2,1,1558,2186,3744,13.463349000000001,13.415935999999999,47.9583,20.334232
20110418,2,1,669,2760,3429,16.0875,17.207636,54.25,10.958988999999999
20110419,2,2,409,2795,3204,15.774151,16.291028000000004,66.5833,10.584057
20110420,2,1,613,3331,3944,19.965,21.249872000000003,61.4167,16.208975
20110421,2,1,745,3444,4189,13.580849,13.956872,40.708299999999994,21.792286
20110422,2,2,177,1506,1683,7.823349,5.248964000000001,72.9583,14.707906999999999
20110423,2,2,1462,2574,4036,13.620000000000001,13.707985999999998,88.79169999999999,15.458575000000002
20110424,2,2,1710,2481,4191,19.338349,20.416358000000002,81.08330000000001,12.875725000000001
20110425,2,1,773,3300,4073,20.513348999999998,21.917,77.6667,12.417311
20110426,2,1,678,3722,4400,21.688349,23.209478000000004,72.9167,21.875500000000002
20110427,2,2,547,3325,3872,21.14,21.959372000000002,83.54169999999999,20.917399999999997
20110428,2,2,569,3489,4058,21.0225,22.209314,70.08330000000001,21.500836000000003
20110429,2,1,878,3717,4595,15.969999999999999,16.832558,45.7083,16.084221
20110430,2,1,1965,3347,5312,14.2075,14.625386000000002,50.3333,15.750025
20110501,2,2,1138,2213,3351,13.228348999999998,13.581464,76.2083,7.125718
20110502,2,2,847,3554,4401,17.810848999999997,19.166978,73.0,12.291418
20110503,2,2,603,3848,4451,20.983348999999997,22.417214,69.7083,22.958689
20110504,2,2,255,2378,2633,11.465848999999999,10.706900000000001,73.70830000000001,22.042732
20110505,2,1,614,3819,4433,13.580849,13.166522,44.4167,19.791263999999998
20110506,2,1,894,3714,4608,14.520849000000002,15.291722,59.0,15.292482
20110507,2,1,1612,3102,4714,16.44,17.832986,54.125,10.750150000000001
20110508,2,1,1401,2932,4333,16.831651,18.249578,63.1667,5.0007125
20110509,2,1,664,3698,4362,17.0275,18.666235999999998,58.875,11.792
20110510,2,1,694,4109,4803,17.0275,18.499586,48.9167,7.749956999999999
20110511,2,1,550,3632,4182,17.4975,18.8744,63.29169999999999,8.083014
20110512,2,1,695,4169,4864,17.145000000000003,18.541958,74.75,12.707689
20110513,2,2,692,3413,4105,16.0875,16.623800000000003,86.33330000000001,12.041575
20110514,2,2,902,2507,3409,16.479150999999998,17.041514,92.25,9.041649999999999
20110515,2,2,1582,2971,4553,18.4375,19.376000000000005,86.70830000000001,10.249593
20110516,2,1,773,3185,3958,19.142500000000002,20.333792000000003,78.79169999999999,8.500357000000001
20110517,2,2,678,3445,4123,18.398349,19.542914000000003,83.7917,18.582718
20110518,2,2,536,3319,3855,17.85,18.792428,87.0,13.499964
20110519,2,2,735,3840,4575,16.949151,17.708972000000003,82.9583,7.250271000000001
20110520,2,1,909,4008,4917,17.223349,18.916772,71.9583,8.375871
20110521,2,1,2258,3547,5805,20.317500000000003,21.750349999999997,62.6667,8.083549999999999
20110522,2,1,1576,3084,4660,20.395849000000002,21.917,74.9583,9.916536
20110523,2,2,836,3438,4274,21.688349,22.959536,81.0,15.667413999999999
20110524,2,2,659,3833,4492,23.020000000000003,23.917658000000003,74.0833,13.875164
20110525,2,1,740,4238,4978,23.059151,24.625772000000005,69.625,10.333611000000001
20110526,2,1,758,3919,4677,25.291651,27.209408000000003,67.75,13.376014
20110527,2,1,871,3808,4679,24.038349000000004,26.042528000000004,65.375,16.125493
20110528,2,1,2001,2757,4758,22.824151,24.417014,72.9583,15.416164
20110529,2,1,2355,2433,4788,23.3725,24.6263,81.875,14.333846
20110530,2,1,1549,2549,4098,26.466651,28.292072000000005,68.5,8.792075
20110531,2,1,673,3309,3982,28.425000000000004,31.875278,63.6667,7.459042999999999
20110601,2,2,513,3461,3974,27.915849,31.583822000000005,67.7083,13.875164
20110602,2,1,736,4232,4968,25.604999999999997,26.500172,30.5,19.583229000000003
20110603,2,1,898,4414,5312,21.14,22.750778000000004,35.4167,16.959107
20110604,2,1,1869,3473,5342,21.845,23.249935999999998,45.625,8.250514
20110605,2,2,1685,3221,4906,22.471651,24.709063999999998,65.25,9.292364000000001
20110606,2,1,673,3875,4548,23.881650999999998,25.042628,60.0,8.167032
20110607,2,1,763,4070,4833,25.252499999999998,27.292700000000004,59.791700000000006,12.583136
20110608,2,1,676,3725,4401,28.464151,32.000414,62.20830000000001,9.166739
20110609,2,2,563,3352,3915,29.991650999999997,34.000214,56.833299999999994,10.042161
20110610,2,1,815,3771,4586,27.485,30.417272000000004,60.5,9.417118
20110611,2,1,1729,3237,4966,26.074999999999996,28.750508000000004,65.45830000000001,10.374949999999998
20110612,2,1,1467,2993,4460,24.5475,26.459450000000004,74.7917,10.958988999999999
20110613,2,1,863,4157,5020,21.845,23.709164,49.4583,20.45845
20110614,2,1,727,4164,4891,20.395849000000002,23.042036000000003,50.708299999999994,18.041961
20110615,2,1,769,4411,5180,21.453349,22.791764,47.1667,11.250104
20110616,2,2,545,3222,3767,21.531651,23.292836,68.8333,13.833556999999999
20110617,2,1,863,3981,4844,22.510849000000004,23.625278,73.5833,9.582942999999998
20110618,2,1,1807,3312,5119,24.743349000000002,26.500964000000003,67.0417,8.000336
20110619,2,2,1639,3105,4744,24.860849,26.625836,66.6667,6.834
20110620,2,2,699,3311,4010,21.845,23.292836,74.625,10.416825
20110621,3,2,774,4061,4835,23.999151,26.084636000000003,77.0417,11.458675000000001
20110622,3,1,661,3846,4507,26.466651,29.792714000000004,70.75,11.541554
20110623,3,2,746,4044,4790,26.231651,29.792978000000005,70.3333,15.999868
20110624,3,1,969,4022,4991,26.035849,27.334478000000004,57.3333,14.875675
20110625,3,1,1782,3420,5202,24.665,26.458658,48.3333,14.041257
20110626,3,1,1920,3385,5305,23.96,26.083514,51.3333,6.3337311
20110627,3,2,854,3854,4708,24.0775,26.042264000000003,65.8333,7.2083960000000005
20110628,3,1,732,3916,4648,26.975849000000004,29.708827999999997,63.416700000000006,9.666960999999999
20110629,3,1,848,4377,5225,26.231651,27.209408000000003,49.7917,17.542007
20110630,3,1,1027,4488,5515,24.743349000000002,26.042528000000004,43.416700000000006,12.415904000000001
20110701,3,1,1246,4116,5362,25.957500000000003,27.042692000000002,39.625,6.874736
20110702,3,1,2204,2915,5119,26.701651,28.042327999999998,44.4583,7.709154
20110703,3,2,2282,2367,4649,25.683349,28.125950000000003,68.25,15.333486
20110704,3,2,3065,2978,6043,26.153349,27.917522000000005,63.7917,5.4591064000000005
20110705,3,1,1031,3634,4665,27.093348999999996,29.958308000000002,59.0417,8.459286
20110706,3,1,784,3845,4629,25.839999999999996,29.251778,74.33330000000001,10.042161
20110707,3,1,754,3838,4592,27.25,29.333486,65.125,10.666400000000001
20110708,3,2,692,3348,4040,25.330849,28.251878000000005,75.79169999999999,15.083643
20110709,3,1,1988,3348,5336,26.466651,27.834428000000003,60.9167,11.250104
20110710,3,1,1743,3138,4881,27.1325,29.541649999999997,57.8333,12.292557
20110711,3,1,723,3363,4086,27.8375,32.167064,63.5833,18.916579
20110712,3,1,662,3596,4258,29.325848999999998,32.79215,55.9167,13.417017999999999
20110713,3,1,748,3594,4342,27.093348999999996,29.500664,63.1667,9.790911000000001
20110714,3,1,888,4196,5084,23.999151,25.916863999999997,47.625,16.124689
20110715,3,1,1318,4220,5538,23.176650999999996,25.208486,59.12500000000001,12.249811
20110716,3,1,2418,3505,5923,24.273349000000003,26.125358,58.5,13.958914
20110717,3,1,2006,3296,5302,25.800849,28.208978000000002,60.4167,16.417211
20110718,3,1,841,3617,4458,27.093348999999996,30.459050000000005,65.125,14.458867999999999
20110719,3,1,752,3789,4541,28.503349,33.333614,65.0417,8.7502
20110720,3,1,644,3688,4332,28.111651000000002,33.2921,70.70830000000001,7.625739
20110721,3,2,632,3152,3784,30.305,38.540486,69.125,14.875407
20110722,3,1,562,2825,3387,31.871651,39.499136,58.0417,8.9177
20110723,3,1,987,2298,3285,31.910849,37.082941999999996,50.0,8.791807
20110724,3,1,1050,2556,3606,31.009999999999998,36.458714,55.0833,11.334456999999999
20110725,3,1,568,3272,3840,26.936650999999998,31.583228,75.7083,6.0841560999999995
20110726,3,1,750,3840,4590,28.268349,30.000614,54.0833,13.417285999999999
20110727,3,1,755,3901,4656,28.425000000000004,29.584022000000004,40.291700000000006,12.292020999999998
20110728,3,1,606,3784,4390,28.620849,32.8334,58.3333,11.958093
20110729,3,1,670,3176,3846,31.401651,35.873822,54.25,11.667245999999999
20110730,3,1,1559,2916,4475,29.795848999999997,32.083442,46.5833,11.291979
20110731,3,1,1524,2778,4302,29.874150999999998,32.166536,48.0833,11.042470999999999
20110801,3,1,729,3537,4266,28.268349,30.417272000000004,55.0833,10.500039
20110802,3,1,801,4044,4845,28.816651,30.666686,49.125,13.79195
20110803,3,2,467,3107,3574,26.388348999999998,28.875842,65.75,9.084061
20110804,3,2,799,3777,4576,25.369999999999997,27.876008000000006,75.75,13.20905
20110805,3,1,1023,3843,4866,25.409151,27.333422,63.083299999999994,12.374632
20110806,3,2,1521,2773,4294,25.683349,28.626164000000003,75.5,15.29275
20110807,3,1,1298,2487,3785,26.8975,31.209272000000006,75.29169999999999,13.499629
20110808,3,1,846,3480,4326,27.955,30.416677999999997,59.2083,12.875725000000001
20110809,3,1,907,3695,4602,28.425000000000004,31.791986,57.04169999999999,10.125107
20110810,3,1,884,3896,4780,28.033349,29.208878,42.4167,13.417285999999999
20110811,3,1,812,3980,4792,25.722500000000004,27.000386,42.375,11.041332
20110812,3,1,1051,3854,4905,25.291651,27.166772,41.5,8.416607
20110813,3,2,1504,2646,4150,24.234151000000004,26.626628000000004,72.9583,14.167418
20110814,3,2,1338,2482,3820,23.803349,25.209608000000003,81.75,14.916411
20110815,3,1,775,3563,4338,23.294151,24.667022000000003,71.20830000000001,13.999918
20110816,3,1,721,4004,4725,24.939151000000003,26.625242,57.8333,15.834043000000001
20110817,3,1,668,4026,4694,25.996651,28.000286000000003,57.5417,9.625689
20110818,3,1,639,3166,3805,25.448349,27.709028000000004,65.45830000000001,15.624936
20110819,3,2,797,3356,4153,24.195,25.792586,72.2917,9.333635999999998
20110820,3,1,1914,3277,5191,24.7825,26.833736000000002,67.41669999999999,6.999289
20110821,3,1,1249,2624,3873,25.409151,28.584650000000003,77.0,16.666518
20110822,3,1,833,3925,4758,24.508349000000003,26.124764,47.0,18.54225
20110823,3,1,1281,4614,5895,22.119151,24.000422,45.5417,9.833121
20110824,3,1,949,4181,5130,23.646651,25.625672,60.5,16.958236
20110825,3,2,435,3107,3542,24.155848999999996,26.626364000000002,77.1667,14.125810999999999
20110826,3,1,768,3893,4661,24.9,27.542378,76.125,5.625487499999999
20110827,3,2,226,889,1115,23.96,25.946696000000003,85.0,25.166338999999997
20110828,3,1,1415,2919,4334,25.231772999999997,26.765293999999997,56.1765,20.412153
20110829,3,1,729,3905,4634,21.923348999999998,24.125228,55.45830000000001,10.708275
20110830,3,1,775,4429,5204,22.040849,23.250464,54.833299999999994,8.375536
20110831,3,1,688,4370,5058,22.863349,24.333986000000003,59.791700000000006,5.5833311
20110901,3,1,783,4332,5115,22.785,24.584786,63.916700000000006,9.500332
20110902,3,2,875,3852,4727,22.236651000000002,23.917327999999998,72.70830000000001,9.375243
20110903,3,1,1935,2549,4484,23.450848999999998,25.792058000000004,71.6667,12.416775
20110904,3,1,2521,2419,4940,25.330849,27.918314000000002,74.20830000000001,13.833289
20110905,3,2,1236,2115,3351,23.646651,25.292636,79.0417,14.250632
20110906,3,3,204,2506,2710,17.380000000000003,18.0032,88.6957,23.044181
20110907,3,3,118,1878,1996,20.160849,19.919114,91.7083,6.500393600000001
20110908,3,3,153,1689,1842,21.793910999999998,20.653826000000002,93.9565,12.914116
20110909,3,2,417,3127,3544,22.55,22.210435999999994,89.79169999999999,8.333393000000001
20110910,3,1,1750,3595,5345,23.020000000000003,24.125492,75.375,10.291736
20110911,3,1,1633,3413,5046,22.706651,24.209114,71.375,7.708618
20110912,3,1,690,4023,4713,22.284356000000002,23.74058,69.2174,5.957171000000001
20110913,3,1,701,4062,4763,22.589151,23.834564,71.25,9.500868
20110914,3,1,647,4138,4785,23.646651,25.3754,69.7083,11.2091
20110915,3,2,428,3231,3659,19.142500000000002,20.542286000000004,70.9167,18.166782
20110916,3,2,742,4018,4760,14.050849,14.457350000000002,59.0417,11.000261
20110917,3,2,1434,3077,4511,15.108349,15.581792,71.8333,12.708225
20110918,3,1,1353,2921,4274,15.8525,16.375442,69.5,11.958361
20110919,3,2,691,3848,4539,17.810848999999997,18.958550000000002,69.0,10.166713999999999
20110920,3,2,438,3203,3641,18.398349,19.126322000000002,88.125,9.041917999999999
20110921,3,2,539,3813,4352,19.965,20.335178000000006,90.0,6.4590814
20110922,3,2,555,4240,4795,21.531651,20.627558,90.2083,8.584375
20110923,4,2,258,2137,2395,20.630849,18.460249999999995,97.25,5.2505689
20110924,4,2,1776,3647,5423,20.513348999999998,21.251192000000003,86.25,5.2516811
20110925,4,2,1544,3466,5010,21.805849000000002,21.794041999999997,84.5,3.3754064
20110926,4,2,684,3946,4630,22.510849000000004,22.876771999999995,84.8333,7.4169
20110927,4,2,477,3643,4120,21.923348999999998,21.91865,88.5417,7.917457
20110928,4,2,480,3427,3907,21.845,21.960427999999993,84.875,9.958143000000002
20110929,4,1,653,4186,4839,20.983348999999997,21.917792,69.91669999999999,11.583161
20110930,4,1,830,4372,5202,18.515849,19.958714,64.75,13.833825
20111001,4,2,480,1949,2429,11.27,11.248957999999998,75.375,19.583832
20111002,4,2,616,2302,2918,8.763349000000002,6.790921999999998,79.1667,14.874870999999999
20111003,4,2,330,3240,3570,10.055848999999998,9.875036000000001,76.0833,5.5841686
20111004,4,1,486,3970,4456,14.755849000000001,15.208628000000001,71.0,13.792218
20111005,4,1,559,4267,4826,17.301650999999996,18.791108,64.79169999999999,11.87575
20111006,4,1,639,4126,4765,15.225849,15.70805,62.083299999999994,9.041917999999999
20111007,4,1,949,4036,4985,16.009151,17.290664,68.41669999999999,1.5002439
20111008,4,1,2235,3174,5409,16.518349,17.873971999999995,70.125,3.0420814
20111009,4,1,2397,3114,5511,17.419151,18.582878,72.75,4.251150000000001
20111010,4,1,1514,3603,5117,18.829151000000003,19.83305,73.375,2.8343814
20111011,4,2,667,3896,4563,18.633349000000003,20.042336,80.875,9.583814
20111012,4,3,217,2199,2416,17.536651,18.169322,90.625,16.62605
20111013,4,2,290,2623,2913,19.690849,20.419064,89.6667,9.499729
20111014,4,2,529,3115,3644,17.889151000000002,18.958550000000002,71.625,15.000161
20111015,4,1,1899,3318,5217,15.813348999999999,16.91585,48.3333,17.291561
20111016,4,1,1748,3293,5041,16.048348999999998,17.208163999999996,48.6667,18.875039
20111017,4,1,713,3857,4570,17.105849,17.70785,57.958299999999994,11.750393
20111018,4,2,637,4111,4748,17.0275,18.499586,70.1667,7.375829
20111019,4,3,254,2170,2424,17.461733,17.913967999999997,89.52170000000001,16.303713
20111020,4,1,471,3724,4195,14.364151,14.790650000000003,63.625,28.292425
20111021,4,1,676,3628,4304,12.092500000000001,11.957335999999998,57.4167,14.833532
20111022,4,1,1499,2809,4308,11.857499999999998,12.082472,62.916700000000006,6.2086689
20111023,4,1,1619,2762,4381,11.818349000000001,11.873978000000001,74.125,6.6673375
20111024,4,1,699,3488,4187,13.776651000000001,14.166422,77.2083,7.959064
20111025,4,1,695,3992,4687,14.168349,14.582749999999997,62.291700000000006,11.166086
20111026,4,2,404,3490,3894,14.755849000000001,15.207836,72.04169999999999,9.959014
20111027,4,2,240,2419,2659,14.09,14.165036,81.2917,13.250121
20111028,4,2,456,3291,3747,7.549151,5.041591999999998,58.58330000000001,15.375093
20111029,4,3,57,570,627,3.945848999999999,-0.9577419999999996,88.25,23.541857
20111030,4,1,885,2446,3331,7.000848999999999,5.207713999999999,62.375,11.833339
20111031,4,1,362,3307,3669,7.98,7.5001580000000025,70.3333,7.12545
20111101,4,1,410,3658,4068,10.839151000000001,10.207808,68.375,9.083257
20111102,4,1,370,3816,4186,9.7425,9.748778000000001,71.875,5.5001439
20111103,4,1,318,3656,3974,11.191651,10.790785999999997,70.20830000000001,9.166739
20111104,4,2,470,3576,4046,10.956651,10.623871999999999,62.25000000000001,18.209193
20111105,4,1,1156,2770,3926,7.353349,5.374364,51.916700000000006,12.667154
20111106,4,1,952,2697,3649,8.371651,7.915628000000002,73.4583,6.1676314
20111107,4,1,373,3662,4035,10.565000000000001,10.457486,75.875,3.834075
20111108,4,1,376,3829,4205,11.191651,11.208236,72.16669999999999,4.6255125
20111109,4,1,305,3804,4109,10.8,10.999214000000002,75.83330000000001,4.1671186
20111110,4,2,190,2743,2933,9.86,8.665586000000001,81.3333,12.667489000000002
20111111,4,1,440,2928,3368,7.235849,4.2499220000000015,44.625,21.083225
20111112,4,1,1275,2792,4067,8.763349000000002,7.624171999999998,55.2917,14.208154
20111113,4,1,1004,2713,3717,12.719151,12.4163,45.8333,18.875307
20111114,4,1,595,3891,4486,16.91,18.624392,58.7083,20.541932
20111115,4,2,449,3746,4195,16.91,17.500214,68.875,13.375411
20111116,4,3,145,1672,1817,13.463349000000001,13.831208,93.0,9.167543
20111117,4,2,139,2914,3053,8.058349,5.332585999999999,57.5833,20.459254
20111118,4,1,245,3147,3392,4.885849,1.9995860000000008,41.0,11.291711
20111119,4,1,943,2720,3663,7.470848999999999,5.415878000000003,50.208299999999994,15.041232
20111120,4,2,787,2733,3520,13.776651000000001,14.165828000000001,68.45830000000001,12.45865
20111121,4,3,220,2545,2765,13.032499999999999,13.374092000000001,91.0,9.249618
20111122,4,3,69,1538,1607,11.583349000000002,11.831936000000002,96.25,7.959064
20111123,4,2,112,2454,2566,12.719151,12.415441999999999,75.79169999999999,22.500275
20111124,4,1,560,935,1495,9.546651,8.583086000000002,54.9167,11.209368000000001
20111125,4,1,1095,1697,2792,9.625,9.124285999999998,64.375,6.6260186
20111126,4,1,1249,1819,3068,9.664151,9.415742000000002,68.1667,4.5841936
20111127,4,1,810,2261,3071,13.580849,14.082799999999999,69.8333,13.999918
20111128,4,1,253,3614,3867,15.663466,16.348052000000003,74.3043,9.522174
20111129,4,2,96,2818,2914,13.541650999999998,13.790750000000003,83.08330000000001,17.292164
20111130,4,1,188,3425,3613,7.275,4.540586000000001,61.3333,18.167586
20111201,4,1,182,3545,3727,6.6875,4.166564000000001,52.4583,14.750586
20111202,4,1,268,3672,3940,6.765848999999999,5.874578,62.583299999999994,6.750518
20111203,4,1,706,2908,3614,6.060849000000001,4.499863999999999,61.291700000000006,6.4174811
20111204,4,1,634,2851,3485,7.549151,7.040600000000001,77.5833,5.6252061
20111205,4,2,233,3578,3811,10.134151,9.99905,82.70830000000001,4.1679561000000005
20111206,4,3,126,2468,2594,13.7375,14.122399999999999,94.9583,15.583061
20111207,4,3,50,655,705,11.27,10.416235999999998,97.04169999999999,17.833725
20111208,4,1,150,3172,3322,4.494150999999999,0.9579079999999998,57.99999999999999,16.083886
20111209,4,1,261,3359,3620,5.669151000000001,4.9577719999999985,69.58330000000001,5.5420189
20111210,4,1,502,2688,3190,4.925000000000001,1.5831920000000004,50.74999999999999,15.625807
20111211,4,1,377,2366,2743,2.3791510000000002,0.708164,49.0,4.458293899999999
20111212,4,1,143,3167,3310,3.201651,1.8329360000000001,67.08330000000001,4.251150000000001
20111213,4,1,155,3368,3523,5.277499999999998,3.875108000000001,59.0,9.41685
20111214,4,2,178,3562,3740,6.922499999999999,6.331892,66.375,4.0842061
20111215,4,2,181,3528,3709,11.857499999999998,11.207642,63.416700000000006,17.958814
20111216,4,2,178,3399,3577,9.625,7.748450000000002,50.0417,17.458525
20111217,4,2,275,2464,2739,4.1416509999999995,0.4584860000000006,56.0833,16.292189
20111218,4,1,220,2211,2431,3.201651,0.20821399999999812,58.62500000000001,11.375193000000001
20111219,4,1,260,3143,3403,5.003349,2.5415779999999977,63.74999999999999,11.584031999999999
20111220,4,2,216,3534,3750,10.134151,10.165963999999999,59.5417,4.1252436
20111221,1,2,107,2553,2660,12.131651000000002,12.249122,85.83330000000001,14.8338
20111222,1,2,227,2841,3068,11.896651000000002,12.123986000000002,75.75,3.1674249999999997
20111223,1,1,163,2046,2209,9.546651,8.915858,68.625,18.374482
20111224,1,1,155,856,1011,6.217499999999999,3.7499719999999996,54.25,12.750368
20111225,1,1,303,451,754,4.914801000000001,2.4774260000000012,68.13040000000001,10.391097
20111226,1,1,430,887,1317,7.121732999999999,4.825310000000002,50.6957,16.044155
20111227,1,2,103,1059,1162,7.275,5.6237780000000015,76.25,12.62615
20111228,1,1,255,2047,2302,6.05911,2.4782839999999986,50.39130000000001,19.695386999999997
20111229,1,1,254,2169,2423,3.6716510000000007,1.4168720000000015,57.4167,8.000604000000001
20111230,1,1,491,2508,2999,6.648349000000001,5.041591999999998,63.6667,9.000579
20111231,1,1,665,1820,2485,11.27,11.331986,61.583299999999994,14.750318
20120101,1,1,686,1608,2294,9.39,8.790986,69.25,12.875189
20120102,1,1,244,1707,1951,4.833020999999999,0.6520639999999993,38.130399999999995,22.087555
20120103,1,1,89,2147,2236,-0.9500000000000002,-7.665850000000001,44.125,24.499957000000002
20120104,1,2,95,2273,2368,-2.9475,-8.123758,41.4583,12.3749
20120105,1,1,140,3132,3272,4.494150999999999,2.3751919999999984,52.416700000000006,8.709128999999999
20120106,1,1,307,3791,4098,7.705848999999999,6.457622000000001,54.2083,11.249836
20120107,1,1,1070,3451,4521,10.486650999999998,9.791414,53.1667,11.708786
20120108,1,1,599,2826,3425,7.862500000000001,6.457028000000001,46.5,12.833314
20120109,1,2,106,2270,2376,2.5358490000000007,0.33361400000000074,70.1667,6.6263000000000005
20120110,1,1,173,3425,3598,6.508712000000001,5.042515999999999,64.65220000000001,12.565984
20120111,1,2,92,2085,2177,4.885849,2.6661859999999997,84.75,8.791807
20120112,1,2,269,3828,4097,9.9775,9.207908,80.2917,12.124789
20120113,1,1,174,3040,3214,4.885849,0.4578920000000011,50.74999999999999,25.333236
20120114,1,1,333,2160,2493,0.4599999999999991,-3.916257999999999,45.75,12.541260999999999
20120115,1,1,284,2027,2311,-0.16665099999999988,-5.332750000000001,41.9167,16.834286
20120116,1,1,217,2081,2298,0.9299999999999997,-3.4162420000000004,52.25,15.500986000000001
20120117,1,2,127,2808,2935,9.533021000000002,8.042348,71.6087,23.39171
20120118,1,1,109,3267,3376,6.2566510000000015,2.1667640000000006,44.333299999999994,27.833743
20120119,1,1,130,3162,3292,0.9299999999999997,-3.4574919999999985,49.75,14.750586
20120120,1,2,115,3048,3163,2.2225,-1.4167720000000017,45.0,13.58425
20120121,1,2,67,1234,1301,0.14665099999999853,-4.45825,83.125,14.917014
20120122,1,2,196,1781,1977,-0.3624999999999998,-5.291499999999999,79.625,13.375746000000001
20120123,1,2,145,2287,2432,2.2616510000000005,0.041827999999998866,91.125,7.417436
20120124,1,1,439,3900,4339,8.0975,7.041127999999997,83.58330000000001,8.292389
20120125,1,1,467,3803,4270,5.825849,3.4581860000000013,64.375,10.791756999999999
20120126,1,2,244,3831,4075,8.058349,7.499299999999998,76.95830000000001,4.9175186
20120127,1,2,269,3187,3456,11.974999999999998,11.415278,74.125,22.958689
20120128,1,1,775,3248,4023,6.844150999999998,5.541013999999997,54.333299999999994,14.125542999999999
20120129,1,1,558,2685,3243,5.277499999999998,1.9995860000000008,31.125000000000004,16.08335
20120130,1,1,126,3498,3624,4.650848999999999,1.3332499999999996,40.0833,14.458064
20120131,1,1,324,4185,4509,10.330000000000002,9.166922,41.6667,17.541739
20120201,1,1,304,4275,4579,14.050849,14.791508,50.79169999999999,12.667489000000002
20120202,1,2,190,3571,3761,10.760849,10.332086,67.29169999999999,12.541528999999999
20120203,1,1,310,3841,4151,6.726650999999999,4.416836,52.6667,11.959232
20120204,1,2,384,2448,2832,4.415849,1.9998499999999986,77.95830000000001,8.167032
20120205,1,2,318,2629,2947,4.494150999999999,1.4583860000000008,68.7917,11.791732000000001
20120206,1,1,206,3578,3784,5.282622999999999,3.564116000000002,62.2174,10.304599999999999
20120207,1,1,199,4176,4375,8.645849000000002,7.832863999999997,49.625,9.874393000000001
20120208,1,2,109,2693,2802,4.063348999999999,1.583786,72.2917,8.959307
20120209,1,1,163,3667,3830,4.455,1.291208000000001,56.2083,13.000478999999999
20120210,1,2,227,3604,3831,5.1991510000000005,3.374828000000001,54.0,7.834243000000001
20120211,1,3,192,1977,2169,2.5358490000000007,-2.0827779999999994,73.125,19.416332
20120212,1,1,73,1456,1529,-2.0075000000000003,-9.290572000000001,46.4583,27.417204
20120213,1,1,94,3328,3422,2.4574999999999996,-0.9577419999999996,41.125,11.207961
20120214,1,2,135,3787,3922,7.000848999999999,6.040436,50.875,9.458993
20120215,1,1,141,4028,4169,8.371651,7.207514000000003,53.125,12.167200000000001
20120216,1,2,74,2931,3005,6.883348999999999,5.790692,75.29169999999999,6.125475000000001
20120217,1,1,349,3805,4154,8.136651,7.207514000000003,63.4583,13.791682
20120218,1,1,1435,2883,4318,8.293349,7.45805,53.4583,12.792243
20120219,1,2,618,2071,2689,5.160000000000002,1.5420080000000027,51.5833,16.958504
20120220,1,1,502,2627,3129,5.160000000000002,2.043806,50.7826,15.348561
20120221,1,1,163,3614,3777,5.5278220000000005,3.477458000000002,59.434799999999996,13.783039
20120222,1,1,394,4379,4773,10.604150999999998,9.916021999999998,56.7917,15.709557
20120223,1,1,516,4546,5062,13.345849000000001,13.333435999999999,55.45830000000001,12.791171
20120224,1,2,246,3241,3487,11.1525,11.124085999999998,73.75,15.916989
20120225,1,1,317,2415,2732,5.669151000000001,0.8745499999999993,39.5833,28.250014
20120226,1,1,515,2874,3389,5.120849,1.708327999999998,41.0,13.750342999999999
20120227,1,1,253,4069,4322,9.233349,7.6249639999999985,49.0833,17.958211000000002
20120228,1,1,229,4134,4363,8.880849000000001,7.3326499999999974,39.5833,12.958939
20120229,1,2,65,1769,1834,8.184356000000001,6.999020000000002,80.4783,12.000839
20120301,1,1,325,4665,4990,14.834151000000002,15.374485999999997,61.5417,15.208129
20120302,1,2,246,2948,3194,8.606651,7.749572000000001,65.7083,9.708568
20120303,1,2,956,3110,4066,11.465848999999999,11.290472000000001,62.125,10.792293
20120304,1,1,710,2713,3423,7.314150999999999,3.9993859999999977,40.3333,22.416257
20120305,1,1,203,3130,3333,3.4366509999999995,-0.08271400000000106,50.625,15.333486
20120306,1,1,221,3735,3956,4.1416509999999995,0.8327719999999985,45.6667,13.458625
20120307,1,1,432,4484,4916,10.995849,9.416599999999999,51.3333,23.167193
20120308,1,1,486,4896,5382,16.792499999999997,18.623863999999998,56.75,29.584721
20120309,1,2,447,4122,4569,11.309151,10.207478000000002,40.708299999999994,27.7916
20120310,1,1,968,3150,4118,5.512499999999999,2.3326220000000006,35.0417,15.125250000000001
20120311,1,1,1658,3253,4911,9.001732999999998,7.738219999999998,47.6957,14.913329000000001
20120312,1,1,838,4460,5298,13.933349,14.333072000000001,48.9167,13.916771
20120313,1,1,762,5085,5847,18.554999999999996,19.833314,61.75000000000001,15.87565
20120314,1,1,997,5315,6312,18.9075,20.208722,50.708299999999994,7.709154
20120315,1,1,1005,5187,6192,18.2025,19.166449999999998,57.958299999999994,10.042161
20120316,1,2,548,3830,4378,12.484151,12.791114,84.20830000000001,7.583864
20120317,1,2,3155,4681,7836,16.165849,17.333036,75.5833,7.417168
20120318,1,2,2207,3685,5892,14.2075,14.624000000000002,81.0,8.501161
20120319,1,1,982,5171,6153,17.615000000000002,19.166185999999996,72.875,10.875238999999999
20120320,1,1,1051,5042,6093,18.359151,19.543178000000005,80.7917,8.125157
20120321,2,2,1122,5108,6230,16.988349,17.875028,82.125,6.000406099999999
20120322,2,1,1334,5537,6871,18.045848999999997,19.083422,83.125,7.876654
20120323,2,2,2469,5893,8362,20.278349,21.624422000000003,69.41669999999999,7.7921000000000005
20120324,2,2,1033,2339,3372,15.617499999999996,16.124378,88.5417,12.916461
20120325,2,2,1532,3464,4996,12.5625,12.874208,88.0833,14.791924999999999
20120326,2,1,795,4763,5558,12.954151,12.9575,47.7917,25.917007
20120327,2,1,531,4571,5102,7.196650999999999,4.833164,28.999999999999996,12.541864
20120328,2,1,674,5024,5698,14.755849000000001,15.082699999999999,48.125,19.541957
20120329,2,1,834,5299,6133,15.225849,15.832063999999999,43.9167,21.41655
20120330,2,2,796,4663,5459,9.39,8.790986,58.0833,9.250489
20120331,2,2,2301,3934,6235,11.935849000000001,11.832728000000003,73.83330000000001,16.791338999999997
20120401,2,2,2347,3694,6041,12.014151000000002,11.540942000000001,67.625,11.541889
20120402,2,1,1208,4728,5936,12.393911,12.215857999999997,50.4348,20.913313
20120403,2,1,1348,5424,6772,13.933349,14.457877999999997,39.6667,6.708911
20120404,2,1,1058,5378,6436,17.458349000000002,19.207699999999996,46.958299999999994,12.125325
20120405,2,1,1192,5265,6457,12.445,12.456758,37.416700000000006,14.708443
20120406,2,1,1807,4653,6460,10.956651,9.790621999999999,37.7083,20.125996
20120407,2,1,3252,3605,6857,12.5625,12.124513999999998,25.4167,18.416356999999998
20120408,2,1,2230,2939,5169,15.5,16.50005,27.5833,15.583931999999999
20120409,2,1,905,4680,5585,14.990849,15.458108,31.75,23.999132
20120410,2,1,819,5099,5918,12.993348999999998,12.791377999999998,43.5,16.708125000000003
20120411,2,1,482,4380,4862,8.388712000000002,6.260084000000003,46.9565,19.783358
20120412,2,1,663,4746,5409,10.682500000000001,9.581864,46.625,19.458743
20120413,2,1,1252,5146,6398,12.7975,12.499328000000002,40.8333,10.416557
20120414,2,1,2795,4665,7460,15.265,16.207735999999997,50.29169999999999,12.791439
20120415,2,1,2846,4286,7132,20.513348999999998,21.875750000000004,50.79169999999999,15.083643
20120416,2,1,1198,5172,6370,23.215849,24.585050000000003,56.166700000000006,19.083543
20120417,2,1,989,5702,6691,20.591651,23.500141999999997,39.0417,18.333143
20120418,2,2,347,4020,4367,13.776651000000001,14.164508000000001,56.9167,11.250104
20120419,2,1,846,5719,6565,15.421651,16.541036,61.25000000000001,4.417256399999999
20120420,2,1,1340,5950,7290,16.753349,18.041150000000002,69.4583,10.041357
20120421,2,1,2541,4083,6624,18.79,19.832786,68.2917,19.000328999999997
20120422,2,3,120,907,1027,10.643349,9.707264000000002,83.54169999999999,23.084582
20120423,2,2,195,3019,3214,7.1183489999999985,3.87425,76.66669999999999,20.334232
20120424,2,1,518,5115,5633,11.426651,10.748678000000002,45.4167,16.708661
20120425,2,1,655,5541,6196,14.403348999999999,15.040921999999998,42.7917,7.959064
20120426,2,2,475,4551,5026,15.421651,15.916477999999998,75.66669999999999,11.833875
20120427,2,1,1014,5219,6233,13.502500000000001,13.874042,40.0833,23.291411
20120428,2,2,1120,3100,4220,9.703349,8.915264,48.9583,8.708325
20120429,2,1,2229,4075,6304,13.541650999999998,13.707985999999998,58.7083,7.8328359999999995
20120430,2,2,665,4907,5572,13.815849,14.207936,56.99999999999999,11.499746
20120501,2,2,653,5087,5740,20.826651000000002,22.083385999999997,65.95830000000001,10.458432
20120502,2,1,667,5502,6169,18.515849,19.501136000000002,79.7083,9.249885999999998
20120503,2,2,764,5657,6421,18.320000000000004,19.457971999999998,76.83330000000001,8.957632
20120504,2,1,1069,5227,6296,21.492499999999996,23.000522000000004,73.54169999999999,10.916846
20120505,2,2,2496,4387,6883,21.218349,22.584128,75.66669999999999,10.250464
20120506,2,2,2135,4224,6359,18.4375,20.084642000000002,74.0,10.041893
20120507,2,2,1008,5265,6273,17.2625,18.791372000000003,66.41669999999999,15.458307000000001
20120508,2,2,738,4990,5728,19.338349,20.793086000000002,68.58330000000001,19.833942999999998
20120509,2,2,620,4097,4717,19.025,20.499650000000003,74.4167,14.499604
20120510,2,1,1026,5546,6572,15.774151,16.457678,55.2083,21.042220999999998
20120511,2,1,1319,5711,7030,17.066650999999997,18.374978,36.0417,15.874779
20120512,2,1,2622,4807,7429,18.515849,19.957921999999996,48.0417,8.249911
20120513,2,1,2172,3946,6118,20.7875,22.625708000000003,57.62500000000001,15.082839
20120514,2,2,342,2501,2843,18.946651,20.293400000000005,78.95830000000001,14.250364
20120515,2,2,625,4490,5115,20.748348999999997,22.042664000000002,79.45830000000001,9.875264
20120516,2,1,991,6433,7424,21.923348999999998,23.33435,69.7917,8.208304
20120517,2,1,1242,6142,7384,19.886651,21.792458000000003,52.0,15.374825000000001
20120518,2,1,1521,6118,7639,18.515849,20.373985999999995,52.33330000000001,9.166739
20120519,2,1,3410,4884,8294,20.2,21.415928,45.625,5.626325
20120520,2,1,2704,4425,7129,21.179150999999997,22.541822000000003,53.041700000000006,17.042589
20120521,2,2,630,3729,4359,20.121651,21.334022000000004,81.125,15.624668
20120522,2,2,819,5254,6073,20.905,22.334450000000004,76.5833,7.917189
20120523,2,2,766,4494,5260,21.218349,22.584392,77.45830000000001,6.834
20120524,2,1,1059,5711,6770,22.785,24.0422,71.6667,11.584031999999999
20120525,2,1,1417,5317,6734,23.96,25.416914,74.70830000000001,9.41685
20120526,2,1,2855,3681,6536,24.5475,26.417936000000005,73.25,13.332464
20120527,2,1,3283,3308,6591,24.43,26.334050000000005,69.7083,14.416457
20120528,2,1,2557,3486,6043,25.487500000000004,28.833800000000004,67.625,13.166907
20120529,2,1,880,4863,5743,25.957500000000003,28.417472000000004,68.45830000000001,19.7918
20120530,2,2,745,6110,6855,22.863349,24.334514,67.0,9.000043
20120531,2,1,1100,6238,7338,23.96,25.667714000000004,49.2917,13.083693
20120601,2,2,533,3594,4127,22.745849000000003,24.125492,75.5417,15.916720999999999
20120602,2,1,2795,5325,8120,19.416650999999998,21.375008,54.9167,12.499654
20120603,2,1,2494,5147,7641,20.317500000000003,21.958778000000002,49.3333,12.333829
20120604,2,1,1071,5927,6998,20.082500000000003,22.166677999999997,48.7083,19.083811
20120605,2,2,968,6033,7001,17.419151,18.708872,61.3333,14.041525
20120606,2,1,1027,6028,7055,18.045848999999997,19.791272,61.12499999999999,5.167375
20120607,2,1,1038,6456,7494,20.317500000000003,21.583171999999998,56.7083,10.542449999999999
20120608,2,1,1488,6248,7736,22.510849000000004,23.458892,46.791700000000006,11.750661000000001
20120609,2,1,2708,4790,7498,25.409151,26.792222000000002,43.7083,9.667229
20120610,2,1,2224,4374,6598,26.153349,27.792122,53.833299999999994,8.959307
20120611,2,2,1017,5647,6664,25.879151,27.541586000000002,58.791700000000006,13.916771
20120612,2,2,477,4495,4972,22.706651,23.45975,83.3333,14.374581999999998
20120613,2,1,1173,6248,7421,22.824151,24.333722,58.2083,22.999693
20120614,2,1,1180,6183,7363,22.471651,25.209278000000005,56.958299999999994,17.000111
20120615,2,1,1563,6102,7665,22.040849,23.583764000000002,58.958299999999994,11.833339
20120616,2,1,2963,4739,7702,21.688349,23.250728000000002,50.416700000000006,11.166689
20120617,2,1,2634,4344,6978,19.8475,21.750349999999997,59.875,9.708568
20120618,2,2,653,4446,5099,18.711651,19.959572,77.79169999999999,11.707982000000001
20120619,2,1,968,5857,6825,24.351650999999997,27.209672000000005,69.0,9.917139
20120620,2,1,872,5339,6211,28.777499999999996,31.58435,59.2083,7.625404
20120621,3,1,778,5127,5905,29.874150999999998,33.667772,56.7917,7.958729
20120622,3,1,964,4859,5823,28.542499999999997,31.791986,57.375,12.250414000000001
20120623,3,1,2657,4801,7458,26.388348999999998,27.084272000000006,53.4583,12.041307
20120624,3,1,2551,4340,6891,26.936650999999998,28.500764000000004,47.9167,9.750174999999999
20120625,3,1,1139,5640,6779,25.644151,27.166772,50.416700000000006,20.125661
20120626,3,1,1077,6365,7442,21.649151,23.250464,37.3333,23.292014
20120627,3,1,1077,6258,7335,24.7825,26.292272000000004,36.0,18.208925
20120628,3,1,921,5958,6879,27.210849000000003,28.583792000000003,42.25,11.50055
20120629,3,1,829,4634,5463,31.205849,35.916458,48.875,11.082939000000001
20120630,3,1,1455,4232,5687,27.955,29.375528000000003,60.12499999999999,10.791756999999999
20120701,3,1,1421,4110,5531,30.344151000000004,33.541514,51.87500000000001,11.291443000000001
20120702,3,1,904,5323,6227,28.738349,30.334508000000007,44.7083,13.082889
20120703,3,1,1052,5608,6660,28.699151,30.374899999999997,49.2083,8.457878999999998
20120704,3,1,2562,4841,7403,29.090849,32.334242,53.87499999999999,9.041649999999999
20120705,3,1,1405,4836,6241,30.8925,34.250222,45.7917,12.999943
20120706,3,1,1366,4841,6207,30.931651000000002,33.667178,45.0833,9.791514
20120707,3,1,1448,3392,4840,32.498349,37.124258,49.2083,10.958118
20120708,3,1,1203,3469,4672,30.6575,36.166136,57.375,8.417143
20120709,3,2,998,5571,6569,25.409151,27.167564,68.3333,12.125325
20120710,3,2,954,5336,6290,25.879151,27.876536,66.75,10.166379000000001
20120711,3,1,975,6289,7264,25.683349,26.917886000000003,63.3333,10.166111
20120712,3,1,1032,6414,7446,25.644151,27.209077999999998,52.9583,9.833924999999999
20120713,3,2,1511,5988,7499,26.388348999999998,28.083578000000003,48.5833,5.41695
20120714,3,2,2355,4614,6969,25.056651000000002,27.958772000000003,69.91669999999999,9.626493
20120715,3,1,1920,4111,6031,27.054150999999997,30.542936000000005,71.7917,11.166689
20120716,3,1,1088,5742,6830,27.876651000000003,31.792250000000003,64.5,11.000529
20120717,3,1,921,5865,6786,30.461650999999996,33.875078,50.583299999999994,7.666743
20120718,3,1,799,4914,5713,29.286651,33.208478,57.7083,9.208614
20120719,3,1,888,5703,6591,28.189999999999998,31.166372000000003,60.0417,11.083743
20120720,3,2,747,5123,5870,23.294151,24.459650000000003,84.4167,14.000789000000001
20120721,3,3,1264,3195,4459,20.004150999999997,20.294191999999995,86.5417,14.2911
20120722,3,2,2544,4866,7410,23.3725,25.126250000000006,76.25,6.2926936
20120723,3,1,1135,5831,6966,26.858348999999997,29.541122,69.41669999999999,9.291761
20120724,3,1,1140,6452,7592,27.289150999999997,30.625700000000002,65.5,14.167418
20120725,3,1,1383,6790,8173,26.035849,27.167564,45.0,11.0416
20120726,3,1,1036,5825,6861,28.503349,32.791358,59.66669999999999,19.082470999999998
20120727,3,1,1259,5645,6904,28.738349,32.458322,59.458299999999994,10.250464
20120728,3,1,2234,4451,6685,27.524150999999996,30.041863999999997,61.3333,10.542449999999999
20120729,3,1,2153,4444,6597,25.918349,28.083578000000003,62.375,11.416532
20120730,3,1,1040,6065,7105,26.349151,29.209142,66.875,10.292339
20120731,3,1,968,6248,7216,25.526651,27.751136000000002,70.41669999999999,11.083475
20120801,3,1,1074,6506,7580,25.722500000000004,28.042327999999998,67.75,9.458993
20120802,3,1,983,6278,7261,27.3675,30.667808,65.95830000000001,8.666718
20120803,3,2,1328,5847,7175,27.994151000000002,31.709222000000004,64.25,14.458064
20120804,3,1,2345,4479,6824,29.286651,33.583622,61.3333,17.249686
20120805,3,1,1707,3757,5464,28.150849,32.251214000000004,65.25,19.458206999999998
20120806,3,2,1233,5780,7013,27.3675,30.876236000000006,65.4167,8.666718
20120807,3,2,1278,5995,7273,26.584151,30.042986000000006,70.375,7.8328359999999995
20120808,3,2,1263,6271,7534,27.25,30.709322,67.29169999999999,7.4169
20120809,3,1,1196,6090,7286,27.524150999999996,30.167528000000004,62.0417,10.458699999999999
20120810,3,2,1065,4721,5786,25.644151,28.084172000000002,71.58330000000001,16.000471
20120811,3,2,2247,4052,6299,24.5475,26.125622,73.2917,13.834093
20120812,3,1,2182,4362,6544,24.939151000000003,26.542214,53.041700000000006,8.208304
20120813,3,1,1207,5676,6883,25.879151,27.708764000000002,54.541700000000006,9.126204
20120814,3,1,1128,5656,6784,26.153349,28.667414,68.6667,11.333586
20120815,3,1,1198,6149,7347,25.213349,27.166441999999996,61.9583,11.374657000000001
20120816,3,1,1338,6267,7605,25.800849,27.209408000000003,51.916700000000006,9.500332
20120817,3,1,1483,5665,7148,25.996651,-0.0015999999999998238,57.0833,15.500718
20120818,3,1,2827,5038,7865,23.881650999999998,24.792686000000003,60.3333,11.917089
20120819,3,2,1208,3341,4549,21.884151,23.834564,71.1667,5.79215
20120820,3,2,1026,5504,6530,21.884151,23.333822000000005,73.4167,8.708593
20120821,3,1,1081,5925,7006,22.510849000000004,23.667650000000002,67.375,4.8756436
20120822,3,1,1094,6281,7375,23.3725,25.042364,67.7083,4.708981100000001
20120823,3,1,1363,6402,7765,24.704151000000003,26.042528000000004,63.5833,5.6679186
20120824,3,2,1325,6257,7582,25.0175,26.708600000000004,61.5,4.8337686
20120825,3,2,1829,4224,6053,23.098349,24.833936,71.2917,16.375336
20120826,3,2,1483,3772,5255,22.706651,23.335735999999997,84.5833,15.333486
20120827,3,1,989,5928,6917,25.056651000000002,27.209408000000003,73.04169999999999,8.625110999999999
20120828,3,1,935,6105,7040,26.231651,27.9593,62.0,12.791975
20120829,3,1,1177,6520,7697,24.195,25.958377999999996,55.2083,7.541653999999999
20120830,3,1,1172,6541,7713,25.213349,27.083413999999998,59.0417,5.1668189
20120831,3,1,1433,5917,7350,27.915849,29.5004,58.75,11.291711
20120901,3,2,2352,3788,6140,27.406651000000004,30.375163999999998,63.8333,7.5835289999999995
20120902,3,2,2613,3197,5810,24.743349000000002,26.834000000000003,81.5,4.2927436
20120903,3,1,1965,4069,6034,25.252499999999998,27.667514000000004,79.0833,10.125107
20120904,3,1,867,5997,6864,26.114151,29.334608000000003,75.5,15.833507
20120905,3,1,832,6280,7112,26.623348999999997,30.792878,74.125,12.583136
20120906,3,2,611,5592,6203,24.743349000000002,27.251714000000007,81.0417,9.542207
20120907,3,1,1045,6459,7504,25.056651000000002,27.375464,73.625,11.500282
20120908,3,2,1557,4419,5976,22.980849,24.333986000000003,79.91669999999999,18.833968000000002
20120909,3,1,2570,5657,8227,20.669999999999998,22.209050000000005,54.75,15.041232
20120910,3,1,1118,6407,7525,19.416650999999998,21.333163999999996,50.375,17.333771000000002
20120911,3,1,1070,6697,7767,19.142500000000002,20.583272,52.0,6.1676314
20120912,3,1,1050,6820,7870,20.160849,21.62495,57.7083,8.833682
20120913,3,1,1054,6750,7804,20.7875,22.250828,63.708299999999994,5.5422936
20120914,3,1,1379,6630,8009,21.766651000000003,23.209478000000004,67.25,6.9588209999999995
20120915,3,1,3160,5554,8714,20.591651,22.667222000000002,50.1667,16.583907
20120916,3,1,2166,5167,7333,19.259999999999998,21.166249999999998,56.99999999999999,6.042281099999999
20120917,3,2,1022,5847,6869,19.299151000000002,20.5013,73.4583,10.166713999999999
20120918,3,2,371,3702,4073,21.296651,21.294421999999997,87.25,23.958329
20120919,3,1,788,6803,7591,17.9675,19.666663999999997,53.6667,14.416725
20120920,3,1,939,6781,7720,17.693349,19.124671999999997,61.8333,7.917189
20120921,3,1,1250,6917,8167,20.160849,21.750086000000003,66.875,10.333343000000001
20120922,3,1,2512,5883,8395,22.55,24.292208000000002,64.6667,19.000061
20120923,4,1,2454,5453,7907,16.870849000000003,18.249578,46.7083,14.958286000000001
20120924,4,1,1001,6435,7436,16.165849,17.165858,49.2917,9.541068000000001
20120925,4,1,845,6693,7538,17.85,19.915813999999997,56.99999999999999,15.833507
20120926,4,1,787,6946,7733,21.845,23.376458,63.083299999999994,16.3748
20120927,4,2,751,6642,7393,22.55,24.126350000000002,69.08330000000001,9.000914
20120928,4,2,1045,6370,7415,21.100849,22.666958,69.0,10.999993
20120929,4,1,2589,5966,8555,17.4975,18.999536,54.2917,15.249468
20120930,4,1,2015,4874,6889,16.753349,18.165757999999997,58.3333,9.042186
20121001,4,2,763,6015,6778,16.479150999999998,17.792,64.9167,6.0838814
20121002,4,3,315,4324,4639,19.769151,19.793977999999996,87.16669999999999,6.9998249999999995
20121003,4,2,728,6844,7572,22.9025,23.542778,79.375,4.4585686
20121004,4,2,891,6437,7328,22.9025,24.126350000000002,72.2917,7.875582
20121005,4,1,1516,6640,8156,20.905,22.292341999999998,62.74999999999999,7.12545
20121006,4,1,3031,4934,7965,18.045848999999997,19.542386,66.41669999999999,17.957675000000002
20121007,4,2,781,2729,3510,11.544151,11.707657999999999,70.8333,9.457854000000001
20121008,4,2,874,4604,5478,10.016651,9.582128,70.9583,12.708492999999999
20121009,4,2,601,5791,6392,12.993348999999998,12.915392,76.16669999999999,12.7501
20121010,4,1,780,6911,7691,16.165849,17.207372,63.083299999999994,12.584007
20121011,4,1,834,6736,7570,12.445,12.457022000000002,46.3333,12.166932000000001
20121012,4,1,1060,6222,7282,12.5625,12.582685999999999,53.91669999999999,15.751164
20121013,4,1,2252,4857,7109,10.486650999999998,9.832136000000002,49.4583,9.791514
20121014,4,1,2080,4559,6639,16.518349,17.541463999999998,64.0417,18.667004000000002
20121015,4,2,760,5115,5875,18.398349,19.5839,70.75,19.834478999999998
20121016,4,1,922,6612,7534,14.011651,14.415835999999999,55.833299999999994,12.208807
20121017,4,1,979,6482,7461,13.424150999999998,13.707128,69.2917,6.791857
20121018,4,2,1008,6501,7509,16.557499999999997,17.83325,72.8333,15.874779
20121019,4,2,753,4671,5424,18.476651,19.501136000000002,81.5,9.041917999999999
20121020,4,1,2806,5284,8090,14.755849000000001,15.207571999999999,57.2917,7.874979
20121021,4,1,2132,4692,6824,13.815849,14.124313999999998,51.0,11.125618000000001
20121022,4,1,830,6228,7058,14.912499999999998,15.874171999999998,56.833299999999994,5.4593811
20121023,4,1,841,6625,7466,17.575848999999998,19.000064000000002,64.16669999999999,6.3345686
20121024,4,1,795,6898,7693,19.6125,20.875586,63.625,4.8762064
20121025,4,2,875,6484,7359,17.85,18.959408000000003,80.0417,8.333125
20121026,4,2,1182,6262,7444,17.654151,18.5015,80.7083,8.875289
20121027,4,2,2643,5209,7852,16.91,17.998777999999994,72.0,15.791364000000002
20121028,4,2,998,3461,4459,14.442499999999999,14.872886000000001,69.4583,26.666535999999997
20121029,4,3,2,20,22,12.68,13.000399999999999,88.0,23.9994
20121030,4,2,87,1009,1096,6.954554000000002,4.453993999999998,82.5455,14.271603
20121031,4,2,419,5147,5566,8.802499999999998,7.832599999999999,66.6667,11.166689
20121101,4,2,466,5520,5986,9.194151000000002,8.416172,58.166700000000006,10.542182
20121102,4,1,618,5229,5847,8.684999999999999,7.498772000000002,52.208299999999994,17.833725
20121103,4,2,1029,4109,5138,8.136651,5.373836000000001,49.125,18.125443
20121104,4,1,1201,3906,5107,7.314150999999999,5.749507999999999,53.2917,12.000236
20121105,4,1,378,4881,5259,7.000848999999999,4.33295,49.416700000000006,15.833775000000001
20121106,4,1,466,5220,5686,5.1991510000000005,2.5834220000000023,56.7083,11.625371
20121107,4,2,326,4709,5035,5.904151000000001,2.124986,54.75,20.375236
20121108,4,1,340,4975,5315,8.552177999999998,6.564806000000001,33.3478,23.304945
20121109,4,1,709,5283,5992,8.998349000000001,7.4572579999999995,54.0833,14.375386
20121110,4,1,2090,4446,6536,10.290848999999998,9.999841999999997,64.5417,3.8756686
20121111,4,1,2290,4562,6852,11.779150999999999,11.833058000000001,65.91669999999999,8.5425
20121112,4,1,1097,5172,6269,14.794999999999998,15.375278000000002,74.16669999999999,11.625639
20121113,4,2,327,3767,4094,8.136651,5.3328500000000005,66.29169999999999,22.917082
20121114,4,1,373,5122,5495,5.590849,2.583158000000001,55.2083,13.374875
20121115,4,2,320,5125,5445,7.1183489999999985,5.416471999999999,62.0417,10.250129000000001
20121116,4,1,484,5214,5698,8.215,6.915464,52.4583,11.458675000000001
20121117,4,1,1313,4316,5629,7.275,5.541277999999998,54.541700000000006,12.041843
20121118,4,1,922,3747,4669,8.0975,6.291235999999998,69.2917,15.250004
20121119,4,2,449,5050,5499,9.899151,8.790986,62.3333,15.749489
20121120,4,2,534,5100,5634,9.585849,9.124022,68.5,5.542575
20121121,4,1,615,4531,5146,8.606651,8.082871999999998,61.375,6.917482000000001
20121122,4,1,955,1470,2425,7.98,7.124485999999997,58.0417,3.5423436
20121123,4,1,1603,2307,3910,9.311651000000001,8.999413999999998,56.875,9.917407
20121124,4,1,532,1745,2277,5.081650999999999,0.4169719999999977,40.4583,25.250357
20121125,4,1,309,2115,2424,3.554150999999999,1.000478000000001,46.8333,10.083499999999999
20121126,4,1,337,4750,5087,6.726650999999999,6.374264,53.541700000000006,3.1255499999999996
20121127,4,2,123,3836,3959,5.708349,2.5828279999999992,78.6667,15.916654
20121128,4,1,198,5062,5260,5.943349000000001,3.1242920000000005,50.625,14.125007
20121129,4,1,243,5080,5323,5.200890000000001,3.695852000000002,55.565200000000004,7.739974
20121130,4,1,362,5306,5668,6.021651,5.375222000000001,64.95830000000001,3.9175436
20121201,4,2,951,4240,5191,6.021651,4.915664,80.6667,4.0001814
20121202,4,2,892,3757,4649,8.3325,7.707728000000003,82.3333,8.333393000000001
20121203,4,1,555,5679,6234,13.267500000000002,14.082535999999998,76.75,5.5422936
20121204,4,1,551,6055,6606,14.364151,14.957564000000001,73.375,11.666643
20121205,4,1,331,5398,5729,12.601651,12.248792000000002,48.5,21.709407
20121206,4,1,340,5035,5375,4.024151,1.0414639999999977,50.875,11.708518
20121207,4,2,349,4659,5008,7.0791509999999995,5.249228000000002,76.4167,8.7502
20121208,4,2,1153,4429,5582,9.938348999999999,9.707528,91.125,6.792393
20121209,4,2,441,2787,3228,10.055848999999998,9.749635999999999,90.5417,10.584325
20121210,4,2,329,4841,5170,12.484151,12.74795,92.5,12.750636
20121211,4,2,282,5219,5501,8.606651,6.331958,59.66669999999999,19.834478999999998
20121212,4,2,310,5009,5319,5.9825,3.624307999999999,53.833299999999994,10.916779
20121213,4,1,425,5107,5532,5.904151000000001,3.4164080000000006,48.5833,11.666643
20121214,4,1,429,5182,5611,5.2383489999999995,3.416672000000002,64.29169999999999,8.792343
20121215,4,1,767,4280,5047,7.235849,6.333278,65.0417,7.12545
20121216,4,2,538,3248,3786,9.037499999999998,8.415907999999998,83.875,6.749714
20121217,4,2,212,4373,4585,10.486650999999998,10.499000000000002,90.7083,6.583306100000001
20121218,4,1,433,5124,5557,11.309151,11.040728000000001,66.625,14.834067999999998
20121219,4,1,333,4934,5267,7.627500000000001,6.5826920000000015,62.5417,12.334164000000001
20121220,4,2,314,3814,4128,7.510000000000002,6.124321999999999,66.79169999999999,8.875021
20121221,1,2,221,3402,3623,7.353349,3.9166220000000003,55.666700000000006,25.083661000000003
20121222,1,1,205,1544,1749,4.494150999999999,-0.4165420000000015,44.125,27.292182
20121223,1,1,408,1379,1787,3.554150999999999,1.1250859999999996,51.5417,8.916561
20121224,1,2,174,746,920,2.871288,1.0874000000000024,79.1304,5.1744368000000005
20121225,1,2,440,573,1013,5.691288,3.43469,73.47829999999999,11.304642
20121226,1,3,9,432,441,3.4366509999999995,-1.4580219999999997,82.3333,21.208582
20121227,1,2,247,1867,2114,3.945848999999999,-1.0416279999999993,65.29169999999999,23.458911
20121228,1,2,644,2451,3095,3.9066509999999983,0.8330359999999999,59.0,10.416557
20121229,1,2,159,1182,1341,3.9066509999999983,-0.0015999999999998238,75.29169999999999,8.333661
20121230,1,1,364,1432,1796,4.024151,-0.7078000000000007,48.3333,23.500518
20121231,1,2,439,2290,2729,2.144150999999999,-1.2498579999999997,57.75,10.374682
